##########
# @      #
#        #
#     $  #
# .$   . #
#        #
#        #
#        #
#        #
##########
