##########
#  .     #
#    @   #
#        #
#     .  #
#     $  #
#        #
#   $    #
#        #
##########
