##########
#      . #
#        #
#     @  #
#  .     #
# $      #
#        #
#     $  #
#        #
##########
