##########
#        #
#        #
#        #
#        #
#  $     #
#  .   . #
#    $   #
#@       #
##########
