##########
#     .  #
#    $   #
#     $  #
#        #
#        #
#     @  #
#     .  #
#        #
##########
