##########
#     @  #
# .      #
#     $  #
#     .  #
#        #
#   $    #
#        #
#        #
##########
