##########
#        #
#        #
#      . #
#   .    #
#        #
# $   $  #
#        #
#     @  #
##########
