##########
#        #
#   $    #
#        #
#       @#
#     $. #
#        #
#       .#
#        #
##########
