##########
#        #
#     $  #
#        #
#  $     #
#        #
#        #
#        #
# @   . .#
##########
