##########
#        #
#     $  #
#        #
#  $     #
#.      @#
#        #
#        #
#      . #
##########
