#######
### $.#
#     #
#    ##
# @ $ #
#    .#
#######
